R 848 480
NO textures/wall_1.xpm
SO textures/wall_2.xpm
WE textures/wall_3.xpm
EA textures/wall_4.xpm
S textures/sprite_1.xpm
ST textures/sky_1.xpm
FT textures/floor_1.xpm
F 184,113,111
C 51,198,111

        1111111111111111111111111
        1000000000000000000000001
        1100000000000000000000001
        1000000000000000000000001
111111111000000000000000000000001
100000000000000000000000000011111
10000000000000E10000000000001    
10000000000000000000000000001    
10000000000000000000000000001    
10000000000000000000000000001     
10000000000000000001010000001     
11000001110101011111011110101     
11110111 1110121 101111010001     
11111111 1111111 111111111111     